111111111111111111111111111111111111111111111111111111111111111111111111111111111111111111111111111111111111111111111111111111111111111111111111111111111111111111111111111111111111
111100000005410000000000011110000000000000000000001111000000000000000000000111100000000000000000000011110000000000000000000001111000000000000000000000111100000000000000000000001111
111100000005310000000000011110000000000000000000001111000000000000000000000111100000000000000000000011110000000000000000000001111000000000000000000000111100000000000000000000001111
111100000005310000000000011110000000000000000000001111000000000000000000000111100000000000000000000011110000000000000000000001111000000000000000000000111100000000000000000000001111
111100001115310000100000011110000000000000000000000000000000000000000000000111100000000000000000000011110000000000000000000001111000000000000000000000000000000000000000000000001111
111100001305310000100000011110000000000000000000000000000000000000000000000111100000000000000000000011110000000000000000000001111000000000000000000000000000000000000000000000001111
111100001305310000100000011110000000000000000000000000000000000000000000000111100000000000000000000011110000000000000000000001111000000000000000000000000000000000000000000000001111
111100001005310000100000011110000000000000000000041111000000000000000000000111100000000000000000000011110000000000000000000001111000000000000000000000111100000000000000000000001111
111100001115310000100000011110000000000000000000051111000000000000000000000111100000000000000000000011110000000000000000000001111000000000000000000000111100000000000000000000001111
111100001305310000100000011110000000000000000000051111000000000000000000000111100000000000000000000011110000000000000000000001111000000000000000000000111100000000000000000000001111
111100001305310000100000011110000000000000000000051111000000000000000000000111100000000000000000000011110000000000000000000001111000000000000000000000111100000000000000000000001111
111100001005310000100000011110000000000000000000051111000000000000000000000111100000000000000000000011110000000000000000000001111000000000000000000000111100000000000000000000001111
111100001115310000100000011110000000000000000000051111000000000000000000000111100000000000000000000011110000000000000000000001111000000000000000000000111100000000000000000000001111
111100001305310000100000011110000000000000000000051111000000000000000000000111100000000000000000000011110000000000000000000001111000000000000000000000111100000000000000000000001111
111100001305310000100000011110000000000000000000051111000000000000000000000111100000000000000000000000000000000000000000000000000000000000000000000000111100000000000000000000001111
111100001005310000100000011110000000000000000000051111000000000000000000000111100000000000000000000000000000000000000000000000000000000000000000000000111100000000000000000000001111
111100001115310000100000011110000000000000000000051111000000000000000000000111100000000000000000000000000000000000000000000000000000000000000000000000111100000000000000000000001111
111100001305310000100000011110000000000000000000051111000000000000000000000111100000000000000000000011110000000000000000000001111000000000000000000000111100000000000000000000001111
111100001305310000100000011110000000000000000000051111000000000000000000000111100000000000000000000011110000000000000000000001111000000000000000000000111100000000000000000000001111
000000001005310000100000000000000000000000000000051111000000000000000000000111100000000000000000000011110000000000000000000001111000000000000000000000111100000000000000000000000000
000000001115310000100000000000000000000000000000051111000000000000000000000111100000000000000000000011110000000000000000000001111000000000000000000000111100000000000000000000000000
000900001005310000100000000000000000000000000000051111000000000000000000000111100000000000000000000011110000000000000000000001111000000000000000000000111100000000000000000033330000
111100111005310000100000011110000000000000000000061111000000000000000000000111100000000000000000000011110000000000000000000001111000000000000000000000111100000000000000000011111111
111100000005310000100000011110000000000000000000001111000000000000000000000111100000000000000000000011110000000000000000000001111000000000000000000000111100000000000000000000001111
111100000005310000100000011110000000000000000000001111000000000000000000000111100000000000000000000011110000000000000000000001111000000000000000000000111100000000000000000000001111
111100000005610000100000011110000000000000000000001111000000000000000000000111100000000000000000000011110000000000000000000001111000000000000000000000111100000000000000000000001111
111103333333333330100000011110000000000000000000001111000000000000000000000000000000000000000000000011110000000000000000000001111000000000000000000000111100000000000000000000001111
111100000000000000100000011110000000000000000000001111000000000000000000000000000000000000000000000011110000000000000000000001111000000000000000000000111100000000000000000000001111
111100002000002000100000011110000000000000002000001111000000000000000200000000000000000000000000000011110000000000000000000001111000000000000000000000111100000000000000000000001111
111111111111111111111111111111111111111111111111111111111111111111111111111111111111111100011111111111111111111111111111111111111111111111111111111111111111111111111111111111111111
111111111111111111111111111111111111111111111111111111111111111111111111111111111111111100011111111111111111111111111111111111111111111111111111111111111111111111111111111111111111
111111111111111111111111111111111111111111111111111111111111111111111111111111111111111100011111111111111111111111111111111111111111111111111111111111111111111111111111111111111111
111111111111111111111111111111111111111111111111111111111111111111111111111111111111111100011111111111111111111111111111111111111111111111111111111111111111111111111111111111111111
